{

  "_id": 10,
  "field": [
    [ 2, 1, 1, 1, 1, 1, 1, 1, 2 ],
    [ 1, 1, 0, 0, 0, 0, 0, 1, 1 ],
    [ 1, 1, 1, 1, 0, 1, 1, 1, 1 ],
    [ 1, 1, 1, 1, 0, 1, 1, 1, 1 ],
    [ 1, 1, 1, 1, 0, 1, 1, 1, 1 ],
    [ 1, 1, 2, 2, 0, 2, 2, 1, 1 ],
    [ 1, 1, 1, 1, 0, 1, 1, 1, 1 ],
    [ 1, 1, 1, 1, 0, 1, 1, 1, 1 ],
    [ 1, 1, 0, 0, 0, 0, 0, 1, 1 ],
    [ 2, 1, 1, 1, 1, 1, 1, 1, 2 ]
  ],
  "goals": [
    [ 0, 20, 0, 30, 20, 0 ],
    [ 0, 0, 0, 0, 0, 0 ]
  ],
  "countOfMoves": 30,
  "awards": null
}