{

  "_id": 11,
  "field": [
    [ 1, 1, 1, 1, 1, 1, 1, 1, 1 ],
    [ 1, 1, 1, 1, 2, 1, 1, 1, 1 ],
    [ 1, 1, 1, 1, 2, 1, 1, 1, 1 ],
    [ 1, 1, 1, 2, 2, 2, 1, 1, 1 ],
    [ 1, 1, 0, 0, 0, 0, 0, 1, 1 ],
    [ 1, 1, 0, 0, 0, 0, 0, 1, 1 ],
    [ 1, 1, 1, 2, 2, 2, 1, 1, 1 ],
    [ 1, 1, 1, 1, 2, 1, 1, 1, 1 ],
    [ 1, 1, 1, 1, 2, 1, 1, 1, 1 ],
    [ 1, 1, 1, 1, 1, 1, 1, 1, 1 ]
  ],
  "goals": [
    [ 30, 0, 20, 0, 0, 30 ],
    [ 0, 0, 0, 0, 0, 0 ]
  ],
  "countOfMoves": 30,
  "awards": null
}