{

  "_id": 8,
  "field": [
    [ 0, 1, 1, 1, 1, 1, 1, 1, 0 ],
    [ 1, 1, 1, 1, 1, 1, 1, 1, 1 ],
    [ 1, 1, 1, 1, 1, 1, 1, 1, 1 ],
    [ 1, 1, 1, 1, 1, 1, 1, 1, 1 ],
    [ 1, 1, 1, 2, 2, 2, 1, 1, 1 ],
    [ 1, 1, 1, 2, 2, 2, 1, 1, 1 ],
    [ 1, 1, 1, 1, 1, 1, 1, 1, 1 ],
    [ 1, 1, 1, 1, 1, 1, 1, 1, 1 ],
    [ 1, 1, 1, 1, 1, 1, 1, 1, 1 ],
    [ 0, 1, 1, 1, 1, 1, 1, 1, 0 ]
  ],
  "goals": [
    [ 0, 20, 20, 0, 0, 0 ],
    [ 0, 0, 0, 0, 0, 0 ]
  ],
  "countOfMoves": 30,
  "awards": null
}