{

  "_id": 12,
  "field": [
    [ 1, 1, 1, 1, 0, 1, 1, 1, 1 ],
    [ 1, 1, 1, 0, 1, 0, 1, 1, 1 ],
    [ 1, 1, 0, 1, 1, 1, 0, 1, 1 ],
    [ 1, 0, 1, 1, 2, 1, 1, 0, 1 ],
    [ 0, 1, 2, 1, 2, 1, 2, 1, 0 ],
    [ 0, 1, 2, 1, 2, 1, 2, 1, 0 ],
    [ 1, 0, 1, 1, 2, 1, 1, 0, 1 ],
    [ 1, 1, 0, 1, 1, 1, 0, 1, 1 ],
    [ 1, 1, 1, 0, 1, 0, 1, 1, 1 ],
    [ 1, 1, 1, 1, 0, 1, 1, 1, 1 ]
  ],
  "goals": [
    [ 0, 20, 20, 20, 20, 0 ],
    [ 0, 0, 0, 0, 0, 0 ]
  ],
  "countOfMoves": 40,
  "awards": null
}